1111111111111111111111111111111111111111111
1111111111111111111111111111111111111111111
1111111111111111111111111111111111111111111
1110P000000G0000111000000000000000000000111
1110000000000000111000000000000000000000111
11100E0000000000111000000000000000000C00111
1110000000000000111000000000000000000000111
1110000000000000111000000000000B00000000111
1111111111100000111000001111111111111111111
111111111110000011100C001111111111111111111
1111111111100000111000001111111111111111111
1110000000000000000000001110000000000000111
1110000000000000000000001110000000000000111
1110000000000C00000000001110000000000C00111
1110000000000000000000001110000000000000111
1110000000000000000000001110000000000000111
1110000011111111111111111110000011111111111
1110000011111111111111111110000011111111111
1110000011111111111111111110000011111111111
1110000000000000000000001110000011100000111
1110000000000000000000001110000011100000111
1110000000000000000000001110000011100C00111
1110000000000000000000001110000011100000111
1110000000000000000000001110000011100000111
1110000011111111111000000000000011100000111
111000001111111111100C0000000C0011100000111
1110000011111111111000000000000011100000111
1110000000000000000000001110000000000000111
1110000000000000000000001110000000000000111
1110000000000000000000001110000000000000111
1110000000000000000000001110000000000000111
1110000000000000000000001110000000000000111
1111111111111111111111111111111111111111111
1111111111111111111111111111111111111111111
1111111111111111111111111111111111111111111
