1111111111
1C10G10E11
10000C0001
1C1001C001
10P00C0001
1111111111
1111111111
