11111
1PCC1
1CCC1
1CCC1
1ECC1
11111
