11111111111111111111111111111111111111111111
1E0010000C11101C111111101C111111101C11111111
11101C0G0111100C000C000C00000000000000000001
100C00100C10101C111111101C111111101C11111111
101111101110101C111111100C111111100C11111111
1P0000101C11101C111111101C111111101C11111111
10111C0C1011101C111111101C111111101C11111111
100000100000001C111111101C111111101C11111111
11111111111111111111111111111111111111111111
