111111111111111111111111111111
1100E000000001C1C1000000000001
100PC000000001C1C1000000000001
10000000000001C1C1000000000001
11000100000001C1C1000000000001
11C1C100000001C1C1000000000001
11C1C100000000C1C0000000000001
11C1C100000001C1C10000000000C1
11C1C100000001C1C1000000000001
11C1C10000000GC1C1000000000001
11C1C100000001C1C1000000000001
11C1C100000001C1C1000000000001
11C1C100000001C1C1000000000001
11C1C100000001C1C1000000000001
11C1C100000000C0C0000000000001
111111111111111111111111111111
