11111111111111
1000C000011111
111011G1111111
1P000000000E11
11010001010C11
11111111111111
