11111111111
1C0000P00E1
11111111111
